grupo_parlamentario,numero_legal,presentes,ausentes,licencias,suspendidos,otros
AP,16,7,9,0,0,0
APAIS,7,3,4,0,0,0
APP,15,5,10,0,0,0
FP,24,19,5,0,0,0
JP,5,5,0,0,0,0
NA,3,2,1,0,0,0
PL,37,23,14,0,0,0
PP,5,1,4,0,0,0
RP,13,10,3,0,0,0
SP,5,5,0,0,0,0
TOTAL,130,80,50,0,0,0
