por_partido,numero_legal,presentes,ausentes,licencias,suspendidos,otros
AP,16,9,7,0,0,0
APAIS,7,6,1,0,0,0
APP,15,11,4,0,0,0
FP,24,21,3,0,0,0
JP,5,4,1,0,0,0
NA,3,3,0,0,0,0
PL,37,18,19,0,0,0
PP,5,4,1,0,0,0
RP,13,8,5,0,0,0
SP,5,4,1,0,0,0
TOTAL,130,88,42,0,0,0