grupo_parlamentario,numero_legal,presentes,ausentes,licencias,suspendidos,otros
AP,16,16,0,0,0,0
APAIS,7,7,0,0,0,0
APP,15,10,5,0,0,0
FP,24,21,3,0,0,0
JP,5,5,0,0,0,0
PL,37,33,4,0,0,0
PP,5,4,1,0,0,0
RP,12,11,1,0,0,0
SP-PM,9,8,1,0,0,0
TOTAL,130,115,15,0,0,0
